1111111111111111111111111111111111111111
1000P00000000000000000000000000000C00001
1010100000000001000000000000100000100001
1010100000000001000000000000111100C00001
1010100011111111111000000000112100100011
101010001100C011111000000C00111100100001
1010100011011011111000000000100101100001
1C101000110100000000000000000101E1010001
1111111111111111111111111111111111111111
