1111111111111111111111111111111111111111
1000P00000001100000000000000000000C00001
1010100000000001000111111000100000100001
1010100000000001000111111000100C00000001
1010100011111111111000000000100000100011
101010001100C011111000000C00100000100001
1010100011011011111000000000100200100001
1C101000110100000000000000000100E0010001
1111111111111111111111111111111111111111
